11 10 2
5555555555
3222222222
1111111111
1111111111
2222322221
1111111111
3222222111
1111112111
1222222111
1111111111
1111011111